Sober | Pnk | no_match | {"title": "Sober", "artist": "Pnk"}
If You Don't Know Me by Now | Simply Red | no_match | {"title": "If You Don't Know Me by Now", "artist": "Simply Red"}
Kiss on My List | Daryl Hall John Oates | no_match | {"title": "Kiss on My List", "artist": "Daryl Hall John Oates"}
It Wasn't Me | Ricardo Ducent | no_match | {"title": "It Wasn't Me", "artist": "Ricardo Ducent"}
Ordinary | Alex Warren | no_match | {"title": "Ordinary", "artist": "Alex Warren"}
I Can Love You Like That | All‐4‐One | no_match | {"title": "I Can Love You Like That", "artist": "All\u20104\u2010One"}
(I've Had) The Time Of My Life | Bill Medley | no_match | {"title": "(I've Had) The Time Of My Life", "artist": "Bill Medley"}
Stay (I Missed You) | Lisa Loeb | no_match | {"title": "Stay (I Missed You)", "artist": "Lisa Loeb"}
Single Ladies (Put a Ring on It) | Beyonce | no_match | {"title": "Single Ladies (Put a Ring on It)", "artist": "Beyonce"}
Try | Pnk | no_match | {"title": "Try", "artist": "Pnk"}
See You Again (feat. Charlie Puth) | Wiz Khalifa | no_match | {"title": "See You Again (feat. Charlie Puth)", "artist": "Wiz Khalifa"}
How Do You Talk To An Angel? | The Heights | no_match | {"title": "How Do You Talk To An Angel?", "artist": "The Heights"}
Somebody's Watching Me | Rockwell | no_match | {"title": "Somebody's Watching Me", "artist": "Rockwell"}
I Just Called To Say I Love You | Stevie Wonder | no_match | {"title": "I Just Called To Say I Love You", "artist": "Stevie Wonder"}
My Heart Will Go On | Celine | no_match | {"title": "My Heart Will Go On", "artist": "Celine"}
Dark Horse | Juicy J | no_match | {"title": "Dark Horse", "artist": "Juicy J"}
Home | Michael Buble | no_match | {"title": "Home", "artist": "Michael Buble"}
There's Nothing Holdin' Me Back | Shawn Mendes | no_match | {"title": "There's Nothing Holdin' Me Back", "artist": "Shawn Mendes"}
Up Where We Belong | Joe Cocker Jennifer Warnes | no_match | {"title": "Up Where We Belong", "artist": "Joe Cocker Jennifer Warnes"}
Irreplaceable | Beyonce | no_match | {"title": "Irreplaceable", "artist": "Beyonce"}
Take on Me | A Ha | no_match | {"title": "Take on Me", "artist": "A Ha"}
I Ran (So Far Away) | A Flock of Seagulls | no_match | {"title": "I Ran (So Far Away)", "artist": "A Flock of Seagulls"}
F**kin' Perfect | Pnk | no_match | {"title": "F**kin' Perfect", "artist": "Pnk"}
Moves Like Jagger | Christina Aguilera | no_match | {"title": "Moves Like Jagger", "artist": "Christina Aguilera"}
Angel | Rayvon | no_match | {"title": "Angel", "artist": "Rayvon"}
Just Another Day | Jon Secada | no_match | {"title": "Just Another Day", "artist": "Jon Secada"}
Tainted Love / Where Did Our Love Go? | Soft Cell | no_match | {"title": "Tainted Love / Where Did Our Love Go?", "artist": "Soft Cell"}
Raise Your Glass | Pnk | no_match | {"title": "Raise Your Glass", "artist": "Pnk"}
Alejandro | Lady Gaga | no_match | {"title": "Alejandro", "artist": "Lady Gaga"}
Maniac | Michael Sembello | no_match | {"title": "Maniac", "artist": "Michael Sembello"}
If You Leave | Orchestral Manoeuvres In The Dark | no_match | {"title": "If You Leave", "artist": "Orchestral Manoeuvres In The Dark"}
Somebody's Baby | Jackson Browne | no_match | {"title": "Somebody's Baby", "artist": "Jackson Browne"}
I'll Stand by You | The Pretenders | no_match | {"title": "I'll Stand by You", "artist": "The Pretenders"}
Hips Don't Lie | Wyclef Jean | no_match | {"title": "Hips Don't Lie", "artist": "Wyclef Jean"}
I Love You | Climax Blues Band | no_match | {"title": "I Love You", "artist": "Climax Blues Band"}
Let's Hear It for the Boy | Deniece Williams | no_match | {"title": "Let's Hear It for the Boy", "artist": "Deniece Williams"}
Physical | Olivia Newton John | no_match | {"title": "Physical", "artist": "Olivia Newton John"}
Bad Romance | Lady Gaga | no_match | {"title": "Bad Romance", "artist": "Lady Gaga"}
All My Life | K Ci Jojo | no_match | {"title": "All My Life", "artist": "K Ci Jojo"}
Upside Down | Diana Ross | no_match | {"title": "Upside Down", "artist": "Diana Ross"}
Girl On Fire | Nicki Minaj | no_match | {"title": "Girl On Fire", "artist": "Nicki Minaj"}
Dynamite | Taio Cruz | no_match | {"title": "Dynamite", "artist": "Taio Cruz"}
What Goes Around...Comes Around | Justin Timberlake | no_match | {"title": "What Goes Around...Comes Around", "artist": "Justin Timberlake"}
Over the Rainbow / What a Wonderful World | Israel Kamakawiwoole | no_match | {"title": "Over the Rainbow / What a Wonderful World", "artist": "Israel Kamakawiwoole"}
Because You Loved Me (Theme from "Up Close and Personal") | Celine Dion | no_match | {"title": "Because You Loved Me (Theme from \"Up Close and Personal\")", "artist": "Celine Dion"}
Seasons Change | Expose | no_match | {"title": "Seasons Change", "artist": "Expose"}
Am I Wrong | Nico Vinz | no_match | {"title": "Am I Wrong", "artist": "Nico Vinz"}
Easy | Commodores | no_match | {"title": "Easy", "artist": "Commodores"}
Tearin' up My Heart | Nsync | no_match | {"title": "Tearin' up My Heart", "artist": "Nsync"}
Let Me Love You | Dj Snake | no_match | {"title": "Let Me Love You", "artist": "Dj Snake"}
Wherever You Will Go | The Calling | no_match | {"title": "Wherever You Will Go", "artist": "The Calling"}
Smooth | Rob Thomas | no_match | {"title": "Smooth", "artist": "Rob Thomas"}
I Still Believe | Brenda K Starr | no_match | {"title": "I Still Believe", "artist": "Brenda K Starr"}
The Climb | Miley Cyrus | no_match | {"title": "The Climb", "artist": "Miley Cyrus"}
Don't Dream It's Over | Crowded House | no_match | {"title": "Don't Dream It's Over", "artist": "Crowded House"}
So Sick | Ne Yo | no_match | {"title": "So Sick", "artist": "Ne Yo"}
I Will Always Love You | Whitney Houston | no_match | {"title": "I Will Always Love You", "artist": "Whitney Houston"}
Cheap Thrills | Sean Paul | no_match | {"title": "Cheap Thrills", "artist": "Sean Paul"}
I Can See Clearly Now | Jimmy Cliff | no_match | {"title": "I Can See Clearly Now", "artist": "Jimmy Cliff"}
Footloose | Kenny Loggins | no_match | {"title": "Footloose", "artist": "Kenny Loggins"}
Blow Me | Pnk | no_match | {"title": "Blow Me", "artist": "Pnk"}
The Power of Love | Celine Dion | no_match | {"title": "The Power of Love", "artist": "Celine Dion"}
Words Get In the Way | Miami Sound Machine | no_match | {"title": "Words Get In the Way", "artist": "Miami Sound Machine"}
Total Eclipse of the Heart | Bonnie Tyler | no_match | {"title": "Total Eclipse of the Heart", "artist": "Bonnie Tyler"}
It's My Life | No Doubt | no_match | {"title": "It's My Life", "artist": "No Doubt"}
I Swear | All‐4‐One | no_match | {"title": "I Swear", "artist": "All\u20104\u2010One"}
Halo | Beyonce | no_match | {"title": "Halo", "artist": "Beyonce"}
Who Knew | Pnk | no_match | {"title": "Who Knew", "artist": "Pnk"}
Say Something | Christina Aguilera | no_match | {"title": "Say Something", "artist": "Christina Aguilera"}
Bad Day | Daniel Powter | no_match | {"title": "Bad Day", "artist": "Daniel Powter"}
I Don't Want To Miss A Thing | Aerosmith | no_match | {"title": "I Don't Want To Miss A Thing", "artist": "Aerosmith"}
Just Give Me a Reason | Nate Ruess | no_match | {"title": "Just Give Me a Reason", "artist": "Nate Ruess"}
Get Lucky | Pharrell Williams | no_match | {"title": "Get Lucky", "artist": "Pharrell Williams"}
Hungry Eyes | Eric Carmen | no_match | {"title": "Hungry Eyes", "artist": "Eric Carmen"}
After All (Love Theme From Chances Are) | Peter Cetera | no_match | {"title": "After All (Love Theme From Chances Are)", "artist": "Peter Cetera"}
a thousand years | Christina Perri | no_match | {"title": "a thousand years", "artist": "Christina Perri"}
Little Red Corvette | Prince | no_match | {"title": "Little Red Corvette", "artist": "Prince"}
The Sweet Escape | Akon | no_match | {"title": "The Sweet Escape", "artist": "Akon"}
Chasing Cars | Snow Patrol | no_match | {"title": "Chasing Cars", "artist": "Snow Patrol"}
Baby, I Love Your Way | Big Mountain | no_match | {"title": "Baby, I Love Your Way", "artist": "Big Mountain"}
Careless Whisper | George Michael | no_match | {"title": "Careless Whisper", "artist": "George Michael"}
I'll Be There | Trey Lorenz | no_match | {"title": "I'll Be There", "artist": "Trey Lorenz"}
I'm Every Woman | Whitney Houston | no_match | {"title": "I'm Every Woman", "artist": "Whitney Houston"}
One Moment in Time | Whitney Houston | no_match | {"title": "One Moment in Time", "artist": "Whitney Houston"}
Uptown Funk | Bruno Mars | no_match | {"title": "Uptown Funk", "artist": "Bruno Mars"}
You Got It All | The Jets | no_match | {"title": "You Got It All", "artist": "The Jets"}
More Than Words | Extreme | no_match | {"title": "More Than Words", "artist": "Extreme"}
Just Give Me a Reason | Pnk | no_match | {"title": "Just Give Me a Reason", "artist": "Pnk"}
Stay | Mikky Ekko | no_match | {"title": "Stay", "artist": "Mikky Ekko"}
Kiss | Prince The Revolution | no_match | {"title": "Kiss", "artist": "Prince The Revolution"}
You Gotta Be | Des’ree | no_match | {"title": "You Gotta Be", "artist": "Des\u2019ree"}
You're Beautiful | James Blunt | no_match | {"title": "You're Beautiful", "artist": "James Blunt"}
I Have Nothing | Whitney Houston | no_match | {"title": "I Have Nothing", "artist": "Whitney Houston"}
Thinking out Loud | Ed Sheeran | no_match | {"title": "Thinking out Loud", "artist": "Ed Sheeran"}
Kokomo | The Beach Boys | no_match | {"title": "Kokomo", "artist": "The Beach Boys"}
Make It Real (Rerecorded) | The Jets | no_match | {"title": "Make It Real (Rerecorded)", "artist": "The Jets"}
Havana | Young Thug | no_match | {"title": "Havana", "artist": "Young Thug"}
Jack & Diane | John Mellencamp | no_match | {"title": "Jack & Diane", "artist": "John Mellencamp"}
What About Us | Pnk | no_match | {"title": "What About Us", "artist": "Pnk"}
Thinkin’ Bout Me | Morgan Wallen | no_match | {"title": "Thinkin\u2019 Bout Me", "artist": "Morgan Wallen"}
I Ain't Comin' Back | Post Malone | no_match | {"title": "I Ain't Comin' Back", "artist": "Post Malone"}
Happyend | Zid | no_match | {"title": "Happyend", "artist": "Zid"}
Divine Timing | Neisha Neshae | no_match | {"title": "Divine Timing", "artist": "Neisha Neshae"}
Alive | Oncue | no_match | {"title": "Alive", "artist": "Oncue"}
McArthur | Tim Mcgraw | no_match | {"title": "McArthur", "artist": "Tim Mcgraw"}
I Dare You | Jonas Brothers | no_match | {"title": "I Dare You", "artist": "Jonas Brothers"}
Tipsy | J Kwon | no_match | {"title": "Tipsy", "artist": "J Kwon"}
Ain't A Bad Life | Thomas Rhett | no_match | {"title": "Ain't A Bad Life", "artist": "Thomas Rhett"}
A Song To Sing | Chris Stapleton | no_match | {"title": "A Song To Sing", "artist": "Chris Stapleton"}
Too Much Fun | Daryle Singletary | no_match | {"title": "Too Much Fun", "artist": "Daryle Singletary"}
One More Last Chance | Chandler Walters | no_match | {"title": "One More Last Chance", "artist": "Chandler Walters"}
Baracoa | Judit Neddermann | no_match | {"title": "Baracoa", "artist": "Judit Neddermann"}
Working In The Coal Mine | The Judds | no_match | {"title": "Working In The Coal Mine", "artist": "The Judds"}
That Ain't My Truck | Rhett Akins | no_match | {"title": "That Ain't My Truck", "artist": "Rhett Akins"}
Love You Again | Chase Matthew | no_match | {"title": "Love You Again", "artist": "Chase Matthew"}
wait in the truck (feat. Lainey Wilson) | Hardy Lainey Wilson | no_match | {"title": "wait in the truck (feat. Lainey Wilson)", "artist": "Hardy Lainey Wilson"}
On Fire | Lloyd Banks | no_match | {"title": "On Fire", "artist": "Lloyd Banks"}
Ring of Fire | Johnny Cash | no_match | {"title": "Ring of Fire", "artist": "Johnny Cash"}
Last Night | Morgan Wallen | no_match | {"title": "Last Night", "artist": "Morgan Wallen"}
When A Cowboy Prays | Brandon Lake | no_match | {"title": "When A Cowboy Prays", "artist": "Brandon Lake"}
Think of You | Cassadee Pope | no_match | {"title": "Think of You", "artist": "Cassadee Pope"}
Remind Me | Carrie Underwood | no_match | {"title": "Remind Me", "artist": "Carrie Underwood"}
Almost Maybes | Jordan Davis | no_match | {"title": "Almost Maybes", "artist": "Jordan Davis"}
Dandelion | Ella Langley | no_match | {"title": "Dandelion", "artist": "Ella Langley"}
Forever After All | Luke Combs | no_match | {"title": "Forever After All", "artist": "Luke Combs"}
She Got the Best of Me | Luke Combs | no_match | {"title": "She Got the Best of Me", "artist": "Luke Combs"}
Whiskey On You | Nate Smith | no_match | {"title": "Whiskey On You", "artist": "Nate Smith"}
Don't Mind If I Do | Ella Langley | no_match | {"title": "Don't Mind If I Do", "artist": "Ella Langley"}
Water At A Wedding | Greylan James | no_match | {"title": "Water At A Wedding", "artist": "Greylan James"}
How Not To | Dan Shay | no_match | {"title": "How Not To", "artist": "Dan Shay"}
Make A Liar | Jackson Dean | no_match | {"title": "Make A Liar", "artist": "Jackson Dean"}
Psychological | The Band Perry | no_match | {"title": "Psychological", "artist": "The Band Perry"}
Tequila | Dan Shay | no_match | {"title": "Tequila", "artist": "Dan Shay"}
Ain't No Love In Oklahoma | Luke Combs | no_match | {"title": "Ain't No Love In Oklahoma", "artist": "Luke Combs"}
What If We Don't | Ashley Mcbryde | no_match | {"title": "What If We Don't", "artist": "Ashley Mcbryde"}
Keeps Me Sane | Tyler Nance | no_match | {"title": "Keeps Me Sane", "artist": "Tyler Nance"}
Hate How You Look | Josh Ross | no_match | {"title": "Hate How You Look", "artist": "Josh Ross"}
Holdin' It Down | Chase Matthew | no_match | {"title": "Holdin' It Down", "artist": "Chase Matthew"}
Killinâ Me | Parker Mccollum | no_match | {"title": "Killin\u00e2\u0080\u0099 Me", "artist": "Parker Mccollum"}
Dream Come True | Carly Pearce | no_match | {"title": "Dream Come True", "artist": "Carly Pearce"}
Never Comin' Back | Flatland Cavalry | no_match | {"title": "Never Comin' Back", "artist": "Flatland Cavalry"}
Get To Drinkin' | Zach John King | no_match | {"title": "Get To Drinkin'", "artist": "Zach John King"}
South Of Sanity | Zach Top | no_match | {"title": "South Of Sanity", "artist": "Zach Top"}
Ride, Ride, Ride | George Birge | no_match | {"title": "Ride, Ride, Ride", "artist": "George Birge"}
You Proof | Morgan Wallen | no_match | {"title": "You Proof", "artist": "Morgan Wallen"}
Cowgirls | Ernest | no_match | {"title": "Cowgirls", "artist": "Ernest"}
Heaven | Kane Brown | no_match | {"title": "Heaven", "artist": "Kane Brown"}
Nothin' Like You | Dan Shay | no_match | {"title": "Nothin' Like You", "artist": "Dan Shay"}
Take It From Me | Jordan Davis | no_match | {"title": "Take It From Me", "artist": "Jordan Davis"}
This Is How We Roll | Luke Bryan | no_match | {"title": "This Is How We Roll", "artist": "Luke Bryan"}
Pour Me A Drink | Blake Shelton | no_match | {"title": "Pour Me A Drink", "artist": "Blake Shelton"}
Boys Back Home | Dylan Marlowe | no_match | {"title": "Boys Back Home", "artist": "Dylan Marlowe"}
Buy Me a Boat | Chris Janson | no_match | {"title": "Buy Me a Boat", "artist": "Chris Janson"}
Gary | Stephen Wilson Jr | no_match | {"title": "Gary", "artist": "Stephen Wilson Jr"}
Golden Child | Meghan Patrick | no_match | {"title": "Golden Child", "artist": "Meghan Patrick"}
World on Fire | Nate Smith | no_match | {"title": "World on Fire", "artist": "Nate Smith"}
It's Five O'Clock Somewhere | Alan Jackson | no_match | {"title": "It's Five O'Clock Somewhere", "artist": "Alan Jackson"}
All My Exes | Chase Matthew | no_match | {"title": "All My Exes", "artist": "Chase Matthew"}
Good Directions | Billy Currington | no_match | {"title": "Good Directions", "artist": "Billy Currington"}
What Ifs | Lauren Alaina | no_match | {"title": "What Ifs", "artist": "Lauren Alaina"}
10,000 Hours | Dan Shay | no_match | {"title": "10,000 Hours", "artist": "Dan Shay"}
Cowboy Songs | George Birge | no_match | {"title": "Cowboy Songs", "artist": "George Birge"}
Back in the Saddle | Luke Combs | no_match | {"title": "Back in the Saddle", "artist": "Luke Combs"}
Miles On It | Marshmello | no_match | {"title": "Miles On It", "artist": "Marshmello"}
Nobody But You (Duet with Gwen Stefani) | Blake Shelton | no_match | {"title": "Nobody But You (Duet with Gwen Stefani)", "artist": "Blake Shelton"}
A Song To Sing | Miranda Lambert | no_match | {"title": "A Song To Sing", "artist": "Miranda Lambert"}
Outskirts | Sam Hunt | no_match | {"title": "Outskirts", "artist": "Sam Hunt"}
Chevy Silverado | Bailey Zimmerman | no_match | {"title": "Chevy Silverado", "artist": "Bailey Zimmerman"}
Choosin' Texas | Ella Langley | no_match | {"title": "Choosin' Texas", "artist": "Ella Langley"}
What Was I Thinkin' | Dierks Bentley | no_match | {"title": "What Was I Thinkin'", "artist": "Dierks Bentley"}
One Number Away | Luke Combs | no_match | {"title": "One Number Away", "artist": "Luke Combs"}
Singles You Up | Jordan Davis | no_match | {"title": "Singles You Up", "artist": "Jordan Davis"}
This Heart | Corey Kent | no_match | {"title": "This Heart", "artist": "Corey Kent"}
Life is a Highway | Rascal Flatts | no_match | {"title": "Life is a Highway", "artist": "Rascal Flatts"}
Thinkinâ Bout Me | Morgan Wallen | no_match | {"title": "Thinkin\u00e2\u0080\u0099 Bout Me", "artist": "Morgan Wallen"}
Ain't A Bad Life | Jordan Davis | no_match | {"title": "Ain't A Bad Life", "artist": "Jordan Davis"}
Country House | Sam Hunt | no_match | {"title": "Country House", "artist": "Sam Hunt"}
It Won't Be Long | George Birge | no_match | {"title": "It Won't Be Long", "artist": "George Birge"}
Don't Happen Twice | Kenny Chesney | no_match | {"title": "Don't Happen Twice", "artist": "Kenny Chesney"}
Truck BED | Hardy | no_match | {"title": "Truck BED", "artist": "Hardy"}
Days Like These | Luke Combs | no_match | {"title": "Days Like These", "artist": "Luke Combs"}
Wish You Well | Vincent Mason | no_match | {"title": "Wish You Well", "artist": "Vincent Mason"}
Sleepless in a Hotel Room | Luke Combs | no_match | {"title": "Sleepless in a Hotel Room", "artist": "Luke Combs"}
Bottle Rockets (feat. Hootie & The Blowfish) | Hootie The Blowfish | no_match | {"title": "Bottle Rockets (feat. Hootie & The Blowfish)", "artist": "Hootie The Blowfish"}
Happen To Me (feat. Jonas Brothers) | Jonas Brothers | no_match | {"title": "Happen To Me (feat. Jonas Brothers)", "artist": "Jonas Brothers"}
Darlin' | Chase Matthew | no_match | {"title": "Darlin'", "artist": "Chase Matthew"}
Timeâs Ticking | Dierks Bentley | no_match | {"title": "Time\u00e2\u0080\u0099s Ticking", "artist": "Dierks Bentley"}
Amen | Jelly Roll | no_match | {"title": "Amen", "artist": "Jelly Roll"}
Uptown Funk | Bruno Mars | no_match | {"title": "Uptown Funk", "artist": "Bruno Mars"}
Thinking out Loud | Ed Sheeran | no_match | {"title": "Thinking out Loud", "artist": "Ed Sheeran"}
Raise Your Glass | Pnk | no_match | {"title": "Raise Your Glass", "artist": "Pnk"}
a thousand years | Christina Perri | no_match | {"title": "a thousand years", "artist": "Christina Perri"}
Dark Horse | Juicy J | no_match | {"title": "Dark Horse", "artist": "Juicy J"}
Seasons Change | Expose | no_match | {"title": "Seasons Change", "artist": "Expose"}
Let's Hear It for the Boy | Deniece Williams | no_match | {"title": "Let's Hear It for the Boy", "artist": "Deniece Williams"}
I Can Love You Like That | All‐4‐One | no_match | {"title": "I Can Love You Like That", "artist": "All\u20104\u2010One"}
Wherever You Will Go | The Calling | no_match | {"title": "Wherever You Will Go", "artist": "The Calling"}
Blow Me | Pnk | no_match | {"title": "Blow Me", "artist": "Pnk"}
Words Get In the Way | Miami Sound Machine | no_match | {"title": "Words Get In the Way", "artist": "Miami Sound Machine"}
I'll Be There | Trey Lorenz | no_match | {"title": "I'll Be There", "artist": "Trey Lorenz"}
So Sick | Ne Yo | no_match | {"title": "So Sick", "artist": "Ne Yo"}
Let Me Love You | Dj Snake | no_match | {"title": "Let Me Love You", "artist": "Dj Snake"}
More Than Words | Extreme | no_match | {"title": "More Than Words", "artist": "Extreme"}
Home | Michael Buble | no_match | {"title": "Home", "artist": "Michael Buble"}
I'll Stand by You | The Pretenders | no_match | {"title": "I'll Stand by You", "artist": "The Pretenders"}
I Love You | Climax Blues Band | no_match | {"title": "I Love You", "artist": "Climax Blues Band"}
If You Don't Know Me by Now | Simply Red | no_match | {"title": "If You Don't Know Me by Now", "artist": "Simply Red"}
Careless Whisper | George Michael | no_match | {"title": "Careless Whisper", "artist": "George Michael"}
Dynamite | Taio Cruz | no_match | {"title": "Dynamite", "artist": "Taio Cruz"}
I Swear | All‐4‐One | no_match | {"title": "I Swear", "artist": "All\u20104\u2010One"}
Jack & Diane | John Mellencamp | no_match | {"title": "Jack & Diane", "artist": "John Mellencamp"}
Cheap Thrills | Sean Paul | no_match | {"title": "Cheap Thrills", "artist": "Sean Paul"}
Hips Don't Lie | Wyclef Jean | no_match | {"title": "Hips Don't Lie", "artist": "Wyclef Jean"}
If You Leave | Orchestral Manoeuvres In The Dark | no_match | {"title": "If You Leave", "artist": "Orchestral Manoeuvres In The Dark"}
All My Life | K Ci Jojo | no_match | {"title": "All My Life", "artist": "K Ci Jojo"}
I Ran (So Far Away) | A Flock of Seagulls | no_match | {"title": "I Ran (So Far Away)", "artist": "A Flock of Seagulls"}
I Will Always Love You | Whitney Houston | no_match | {"title": "I Will Always Love You", "artist": "Whitney Houston"}
Kiss on My List | Daryl Hall John Oates | no_match | {"title": "Kiss on My List", "artist": "Daryl Hall John Oates"}
Single Ladies (Put a Ring on It) | Beyonce | no_match | {"title": "Single Ladies (Put a Ring on It)", "artist": "Beyonce"}
Try | Pnk | no_match | {"title": "Try", "artist": "Pnk"}
What Goes Around...Comes Around | Justin Timberlake | no_match | {"title": "What Goes Around...Comes Around", "artist": "Justin Timberlake"}
Somebody's Watching Me | Rockwell | no_match | {"title": "Somebody's Watching Me", "artist": "Rockwell"}
Who Knew | Pnk | no_match | {"title": "Who Knew", "artist": "Pnk"}
I Can See Clearly Now | Jimmy Cliff | no_match | {"title": "I Can See Clearly Now", "artist": "Jimmy Cliff"}
Over the Rainbow / What a Wonderful World | Israel Kamakawiwoole | no_match | {"title": "Over the Rainbow / What a Wonderful World", "artist": "Israel Kamakawiwoole"}
Ordinary | Alex Warren | no_match | {"title": "Ordinary", "artist": "Alex Warren"}
Because You Loved Me (Theme from "Up Close and Personal") | Celine Dion | no_match | {"title": "Because You Loved Me (Theme from \"Up Close and Personal\")", "artist": "Celine Dion"}
Bad Romance | Lady Gaga | no_match | {"title": "Bad Romance", "artist": "Lady Gaga"}
Footloose | Kenny Loggins | no_match | {"title": "Footloose", "artist": "Kenny Loggins"}
Kiss | Prince The Revolution | no_match | {"title": "Kiss", "artist": "Prince The Revolution"}
Say Something | Christina Aguilera | no_match | {"title": "Say Something", "artist": "Christina Aguilera"}
Sober | Pnk | no_match | {"title": "Sober", "artist": "Pnk"}
Kokomo | The Beach Boys | no_match | {"title": "Kokomo", "artist": "The Beach Boys"}
See You Again (feat. Charlie Puth) | Wiz Khalifa | no_match | {"title": "See You Again (feat. Charlie Puth)", "artist": "Wiz Khalifa"}
Irreplaceable | Beyonce | no_match | {"title": "Irreplaceable", "artist": "Beyonce"}
Moves Like Jagger | Christina Aguilera | no_match | {"title": "Moves Like Jagger", "artist": "Christina Aguilera"}
Bad Day | Daniel Powter | no_match | {"title": "Bad Day", "artist": "Daniel Powter"}
F**kin' Perfect | Pnk | no_match | {"title": "F**kin' Perfect", "artist": "Pnk"}
Physical | Olivia Newton John | no_match | {"title": "Physical", "artist": "Olivia Newton John"}
I Don't Want To Miss A Thing | Aerosmith | no_match | {"title": "I Don't Want To Miss A Thing", "artist": "Aerosmith"}
Just Give Me a Reason | Nate Ruess | no_match | {"title": "Just Give Me a Reason", "artist": "Nate Ruess"}
I Still Believe | Brenda K Starr | no_match | {"title": "I Still Believe", "artist": "Brenda K Starr"}
Get Lucky | Pharrell Williams | no_match | {"title": "Get Lucky", "artist": "Pharrell Williams"}
One Moment in Time | Whitney Houston | no_match | {"title": "One Moment in Time", "artist": "Whitney Houston"}
Angel | Rayvon | no_match | {"title": "Angel", "artist": "Rayvon"}
You're Beautiful | James Blunt | no_match | {"title": "You're Beautiful", "artist": "James Blunt"}
It Wasn't Me | Ricardo Ducent | no_match | {"title": "It Wasn't Me", "artist": "Ricardo Ducent"}
After All (Love Theme From Chances Are) | Peter Cetera | no_match | {"title": "After All (Love Theme From Chances Are)", "artist": "Peter Cetera"}
The Sweet Escape | Akon | no_match | {"title": "The Sweet Escape", "artist": "Akon"}
Tearin' up My Heart | Nsync | no_match | {"title": "Tearin' up My Heart", "artist": "Nsync"}
